von
abhängig sein von – зависеть от чего-то
begeistert sein von – быть взволнованным чем-то
überzeugt sein von – быть убежденным в чем-то
enttäuscht sein von – быть разочарованным в чем-то
entfernt sein von – быть отдаленным от чего-то
auf A
ärgerlich sein auf A – злиться из-за чего-то
böse sein auf A – злиться из-за чего-то
angewiesen sein auf A – быть уверенным в чем-то
eifersüchtig sein auf A – завидовать чему-то
stolz sein auf A – быть гордым чем-то
an D
interessiert sein an D – быть заинтересованным в чем-то
erkrankt sein an D – быть больным чем-то
reich sein an D – быть богатым чем-то
schuld sein an D – быть виноватым в чем-то
beteiligt sein an D – быть задействованным в чем-то
zu
freundlich sein zu – быть дружественным к кому-то
(un)fähig sein zu – быть способным \ быть неспособным на что-то
Bereit sein zu – быть готовым на что-то
nett sein zu – быть любезным с кем-то
entschlossen sein zu – решиться на что-то
bei
angesehen sein bei – быть в почете среди кого-то
(un)beliebt sein bei – быть не любимым среди
gegenüber
zurückhaltend sein gegenüber – быть сдержанным перед кем-то
aufgeschlossen sein gegenüber – быть открытым перед кем-то
gegen A
(un)empfindlich sein gegen A – быть нечувствительным к чему-то
immun sein gegen A – быть неуязвимым к чему-то
an A
adressiert sein an A – быть адресованным кому-то	
gewöhnt sein an A – привыкнуть к чему-то
für
(un)geeignet sein für – быть пригодным \ быть непригодным к чему-то
verantwortlich sein für – быть ответственным за что-то
(un)wichtig sein für – быть важным \ быть неважным для
(un)schädlich sein für – быть вредным \ быть безвредным для
nützlich sein  für – быть полезным для
mit
befreundet sein mit – быть дружественным кому-то
verwandt sein mit – быть родственным для кого-то
zufrieden sein mit – быть довольным чем-то
beschäftigt sein mit – быть занятым чем-то
fertig sein mit – быть готовым с чем-то
nach
verrückt sein nach – сходить с ума из-за
in A
unterteilt sein in A – быть разделенным на 
verliebt sein in A – быть влюбленным в кого-то
über
glücklich sein über – быть радостным из-за
erfreut sein über – быть обрадованным чем-то
erstaunt sein über – быть изумленным чем-то	
traurig sein über – быть грустным из-за
verwundert sein über – быть удивленным чем-то
wütend sein über – быть в ярости из-за
in D
(un)erfahren sein in D – быть опытным \ быть неопытным в чем-то
gut sein in D – быть хорошим в чем-то \ быть хорошим для чего-то
nachlässig sein in D – быть неосторожным в 

