C1 Kursbuch Kapitel 2

belegen - доказывать (научным путём)
von Natur aus - от природы
anhang - с помощью / по средством / пользуясь / зная
ein Medikament gegen Kopfschmerzen - средство от головной боли 
behandeln - лечить 
Diagnosse stellen - ставить диагноз 
zunachst - сначала, прежде всего 
allmahlich - постепенно 
die Werkstatt - мастерская, цех, СТО
mutma?lich - предположительный, вероятный
umfangreich - объемный 
vorsichtshalber - на всякий случай, в целях предосторожности 
widerlegen - опровергать
zwischenmenschlich - межличностный
den Humor erwerben - приобретать чувство юмора 
vom diesem Standpunkt - с этой точки зрения 
erfassen - понимать 
der Pechvogel - неудачник 
schlittern in - скользить 
in den Griff bekommen - принимать во внимание 
der Stillstand - затишье, застой 
verherrlichen - прославлять 
ergiebig - плодородный, обильный 
sich eignen als - считать себя 
jemandem vergehen - пропадать 
der Streich - выходка 
hereinlegen - прикалывать, разводит 
glaubhaft - правдоподобный 
umschlagen in Akk - превращаться в 
der Leistungssport - большой спорт 

