The Financier

immense - огромный
to reckon - подсчитывать, насчитывать, исчислять
liable - связанный обязательством
merely - только, просто
loft - чердак 
designated - определять, устанавливать
vault - подвал
to urge - побуждать
to compel - заставлять, принуждать
runabout - дрожки
impending - надвигающийся
splendid - блестящий, отличный
quaint - причудливый
stern - суровый, жестокий
placid - спокойный, мирный
foster - воспитывать
divinity - бажественность
utterly - чрезвычайно
yield - пложы, урожай
mistress - хозяйка
ominously - предвещаюхий недоброе
to sustain - подпирать
to confess - исповедоваться
adjust things - привест вещи в порядок
literally - буквально, дословно
to blame - порицать
solemnly - торжественно
audacity - смелость, твага
decent - приличный
banister - перила
to draw near - придвигаться
earnestly - настоятельно
foreshadow - предзнаменование 
rival - соперник
sewer - швея
rumor - слух
sly - хитрый
afford - иметь возможность
erected - воздвигнутый
genially - сердечно
temperate - умеренный
to preserve - созранять, оберегать
stocks - активы
ingratiating smile - обаятельная улыбка
frank - искренный
to pour - лить
abandon - отказываться
thumb - большой палец
vest - нижняя рубашка
warrant - патент
devote - посвящать
sagacity - сообразительность
morrow - следующий день
briskly - оживленно, поспешно
to retain - сдерживать
to vouch - ручаться
innate - коренной житель
vigorously - рьяно
convict - кторжник
rejoinder - возражение ответчика
to fluster - волновать
tentatively - экспериментально
tangled situation - запутанная ситуация
scrawling hand - неразборчивый почерк
vicinity - соседство
doorstep - порог
bothering - надоедливый
brusquely - бесцеремонно
to contemplate - созерцать
to denounce - осуждать
to assault - приступ, нападки
scoundrel - негодяй
to conceal - укрывать
to alter - изменять
a penitentiary - исправительный дом
alacrity - живость
to commiserate oneself - сочувствовать
to evolve - развивать
to deceive - обманывать
denouement - зверршение, исход
unjust - несправедливый
pecular way - неправедный путь
suspend - вешать, подвешивать
to confer - даровать
to justify - оправдывать
hypothecate - выдвигать гипотезу
to exceed - превышать
vicious - порочный, равратный
to undertake - совершить
proposition - утверждение
likelihood - вероятность
to entitle - давать название
to oblige - обязывать
unquestionably - бесспорно
to anticipate - ожидать, предвидеть
to presume - полагать
withdrawal - отнятие, изъятие
to emphasize - подчеркнуть
bailee - лицо, отчетственное за зранение товара
incarceration - лигение совбоды
consciousness - сознательность
dubious - сомнительный  
delighted - восхищенный
caution - осторожность
console - утешать
to divert - отклонять
inwardly - внутри
to undo - омтенять
consolation - утешение
resignation - отказ от должности
to designate - назначенный, но еще не вступивший в должность
convulsively - судорожно
puzzled - озадаченный
furtive - скрытый, тайный
intimate - закадычный друг
to object - возвращать
mansion - большой особняк
to take a leap - взять препятствие
gingerly - осмотрительно
to respond - отвечать
defiant - вызывающий
to disgrace - позорить
spiritually - одухотворенно
peculiar thing - личная вещь
to suborn - подкупать
to reproach - упрекать
scarcely - едва
notion - взгляд мнение
nonsense - вздор, ерунда
to accomplish - выполнять, завершать
walnut - грецкий орех
unwholesome - нездоровый
to evade - ускользать
to abominate - питать отвращение
attorney - адвокат
defendant - обвиняемый
testimonial - рекомендация
subtlety - тонкость
to twist - крутить
overrule - верховная власть
to dismiss - отпускать, увольнять
dismissal - роспуск
collateral - родственник по боковой линии
to offset - потомок
overdraft - превышение кредита
juror - член жюри
to legitimate - законорожденный ребенок
sane - в своем уме
to hear one out - выслушать
solvency - платежеспособность
elusive - неуловимый 
illusive - обманчивый
cogitation - обдумывание
deliberate - намеренный
rostrum - трибуна, кафедра
ingratitude - неблагодарность
to adore - обожать
perplex - растерянный
relish - наслаждение
ruthless - безжалостный
merit - заслуга, достоинство
to be on the verge - быть на грани
knotty question - грубый вопрос
undergo - испытывать, переносить
ticklish - боящийся, щекотки
to venture - рискованная попытка
lackadaisical - апатичный
affectionatte - любящий
warden - надзиратель
croon - проникновенное пение
disconsolate - безутешный
to forego - предшествовать  
to condemn - осуждать, порицать
to deplore - сожалеть
untoward - несчастливый
nod - кивать 
larceny - воровство
to aggravate - ухудшать, усиливать
fraud - обманщик
extenuation - изнурение
inviolable rule - незыблемое правило
swindler - мошенник, жулик
turmoil - беспорядок
purloined - пхищенный
oppressive - жестокий. деспотичный
to commiserate - сочувствовать
decency - приличие
to oppose - противиться
survey - соцопрос
to bother - беспокоить
to redound - сказаться
to dispose of - располагать чем-то
timber - лесоматериалы
deemed - условный
