unverbindlich – ни к чему не обязывающий, слишком общий
seicht – мелководный, ограниченный (умственно)
dünn - тонкий, худой, редний (волосы)
unleserlich - неразборчивый
dicht - плотный, непроницаемый
welk - вялый, блеклый
dürr - сухой, высохший
heiser – хриплый, охрипший
verschwommen – туманный, расплывчатый
artig – вежливый, воспитанный
gepflegt – ухоженный
kultiviert – образцовый, умственно развитый
planmäßig – планомерный, штатный
zahn - ручной
schwerfällig – неповоротливый, неуклюжий
solide – солидный, надежный
dumpf  - глухой, затхлый
faul – ленивый, гнилой, тухлый, затхлый
matt – слабый, вялый
ranzig – прогорклый, затхлый
schal – безвкусный, пресный
schwül – душный, знойный
unverfroren – наглый, дерзкий
unwirsch – грубый, неприветливый
unschlüssig - неприветливый
schlüssig - обоснованный, убедительный
unnahbar – высокомерный, неприступный
ungestüm – вспыльчивый, стремительный
unverhofft - неожиданный
unbeschwert – беззаботный, неотягощенный
berechtigt - резонный
unbeholfen - нерасторопный, неловкий, неуклюжиый
besonnen - рассудительный
gedrückt – угнетенный, подавленный

vollkommen - полный, совершенный, абсолютный
ungekürzt - неукороченный, неубавленный
voll - полный, заполненный, исполненный
vollständig - полный (о данныйх), совершенный (о покое), абсолютно, совершенно
ausnahmslos - не знающий исключений
vollzählig - полный, в полном составе
umfassend - обшщирный, всеобъемлющий, широко, всеобъемлюще
lückenlos - полный, без пробелов, нерперывный, сплошной
vollauf - вдоболь, достаточно, вполне
unversehrt - невредимый, целый
völlig - полный, совершенный
gesamt - весь, целый, общий, совокупный
sämtlich - все (без исключения)
rundweg - сразу, прямо
vollendet - совершенный, законченный,завершенный
einheitlich - единый, стадартный
uneingeschränkt - неограниченный
total - всеобщиий, полный



