Antonymen

e Muße - время прилежного делания раби себя
e Unrast - неугомонность, обеспокоеннсть

e Nachsicht - снисхождение
e Härte - твёрдость

e Langweile - скука
e Tätigkeit - занятость (есть что делать)

e Geborgenheit - чувство безопасности
e Verlassenheit - заброшенность, одиночество

r Eigennutz - корысть
e Hilfsbereitschaft - готовность помочь 

e Heiterkeit - веселость
e Traurigkeit - грустность

e Anteilnahme - участие, сочувствие
e Gleichg[ltigkeit - безразличие

s Vertrauen - доверие
r Argwohn - недоверие

e Aufrichtigkeit - искренность
e Verlogenheit - лживость

s Lob - похвала
r Tadel - порицание

s Entgegenkommen - хождение навстречу
r Widerspruch - сопростивление

e Grobheit - грубость
e Höflichkeit - вежливость

e Anerkennung - признание
e Mißschätzung - неуважение, презрение

e Zustimmung - согласие
e Zurückwisung - отказ

r Nutzen - польща
r Schaden - вред

e Ehre - честь
e Schande - стыд, бесчестье

e Freiheit - свобода 
r Zwang - принуждение

e Gerechtigkeit - справедливость
s Fanatismus - фанатизм

r Aufbau - постройка, развитие
e Zerstörung - уничтожение

e Treue - верность
r Verrat - предательство

r Willkür - произвол (e Ordnung)

e Fülle - изобилие
e Mangel - недостаток

r Ruhm - слава
r Schmach - позор, бесславие
