Liebe Deinen Nächsten Kapittel 1

brodelnd - кипящий
brodeln - кипеть
lauschen - подлушивать
horchen - подлушивать
schimmern - блестеть 
schnarchen - храпеть
r Pfosten - столб
wirres Haar - запутанные, растрепанные волосы
horchen - подлушивать
knurren - рычать
r Ausguß - слив
huschten - прошмыгнуть
taub - онемелый
r Lauf - бег
nachäffen A - дразнить
verziehen - избаловывать
kichern - хихикать
kreischen - визжать
stöhnen - сетовать, жаловаться
schmächtig - тощий, худой
e Schnauze - морда
den Mund verbieten - затыкать рот
der Entschluß - решение намерение
geisterhaft - призрачный
r Hohn - насмешка
e Frechheit - дерзость
frech - дерзкий, наглый
ausbürgern - лишать гражданства, экстралировать
ausweisen - высылать (из страны)
gähnen - зевать
e Bude - лавка, ларек
r Kasten - ящик
s Gemüt - нрав
entkorken - откупоривать
jmn bedauern - жалеть кого-то 
graben - копать рыть
die Furche - борозда, морщина
allerhand - по всякому, всякий, разнообразный
erbärmlich - жалкий
die Zelle - партийная ячейка
notdürftig - бедный, скудный

 