NDR DOKU

ertragen - переносить, терпеть, сносить
rechtfertigen - оправдать, обосновать
berechtigen - уполномочивать
einfordern А - потребовать, затребовать
der Vorstand - правление, председатель
der Verstand - ум
die Verwaltung - управление, администрация
der Verwaltungrat - совет директоров

reibundslos - бесприпятственный, бесперебойный
einwandfrei - безукоризненный
entwefen - проектировать
pauschal - общий, безлимитный
pauschalisieren - обощать, делать общие выводы
das Pauachalkosten - общий расходы
verwirklichen - осуществлять
die Immobilie - недвижимость
ungeheuer - ужасный, огромный
zwingend - обязательно
dringend - срочно
die Blutentnahme - забор крови, анализ крови

sich erhärten - укрепляться
die Spanne - промежуток
die Preisspanne - ценовые рамки
die Gemeinde - община
der Umkreis - район, округа
einmessen - отмерять
blenden - ослеплять
lebendig - полный жизни
erwirtschaften - зарабатывать
der Magnet - магнит
ausschütteln - встряхивать, вытряхивать

die Angel - удочка
r Hacken - крючок
e Angelleine = e Angelschnur - леска
der Hebel - рычаг
depremiert - подавленный
zuversichtlich - обнадеживающий
e Zuversicht - глубокое убеждение
überwachen Akk - наблюдать за
gestehen - признаваться
zugestehen - признаваться, уступать (юр)
das Zugeständnis - уступка, признание (юр)
umgekehrt - наоборот
s Regiment - власть, правление
wundersam - чудесный
die Genehmigung - разрешение

r Ausschuß - комитет = брак = отходы
gestreift - полосатый
benennen nach - называть учесть

e Bückware - товар на нижней полке супермаркета
sich ergeben - оказываться получаться (если.., то получится)
e Schicht - смена, слой
e Wehr - пожарная команда, плотина