ROHLINGE:

der Goldschmied - ювелир
die Espen - осина
e Eiche - дуб
r Achorn - клён
e Linde - липа
der Kreisverkehr - перекрёстное движение
die Kreuzung - перекрёсток
es sit mir ausgegangen - заканчиваться
unermüdlich - неустанно
fahrig - расторопный, суетливый
die Pachtung - договор аренды
die Garbe - сноп
der Tümpel - пруд, лужа, стоячая вода
der Fäden - саженец, нитка
der Verfall - гибель
allmählich - постепенно
переворачивать - herumdrehen, umkehren, umschlagen (страницы)
die Sprosse - ступенька
die Treppe - лестница
übergießen - заливать заварку, выливать, проливать
die Raureif - изморозь
die Sorgfalt - тщательность, точность, старание
die Last - ноша, груз
die Zwischenzeit - промежуток времени
aufbrechen - взламывать (дверь)
die Bedingung - условие
die Pampelmuse - грейпфрут
großspurig - надменный, кичливый
die Schmuggelware - контрабанда
toben - бушевать, свирепствовать, психовать
fluchen - браниться, сквернословить
unverzüglich - немедленно,
пренебрегать -  vernachlässigen, nachlässigen (математик.), geringachten, geringschätzen
den Hörer abnehmen - поднимать трубку
taumeln - подкачиваться, нетвердо стоять на ногах
das Versprechen halten - держать обещание
r Füllhalter - авторучка
auftauchen - сплывать, выныривать
pl Trauben = Weintrauben - виноградные грозди
e Wildnis - глухая местность