der Goldschmied - ювелир 
die Espen - осина 
der Kreisverkehr - перекрёстное движение  
die Kreuzung - перекрёсток 
es ist mir ausgegangen - заканчиваться 
unermüdlich - неустанно 
fahrig - расторопный, суетливый 
die Pachtung - договор аренды 
die Garbe - сноп 
der Tumpel - пруд, лужа, стоячая вода 
der Faden - саженец, нитка 
der Verfall - гибель 
allmählich - постепенно 
verdaunen - переваривать 
die Sprosse - ступенька 
übergießen - заливать заварку, выливать, проливать 
die Raureif - изморозь
die Sorgfalt - тщательность, точность, старание
die Last - ноша, груз 
die Zwischenzeit - промежуток времени
aufbrechen - взламывать (дверь)
die Bedingung - условие 
die Pampelmuse - грейпфрут 
großspurig - надменный, кичливый 
der Ahorn - клён 
die Schmuggelware - контрабанда 
toben - бушевать, свирепствовать, психовать 
fluchen - браниться, сквернословить
unverzuglich - немедленно, безотлагательно 
vernachlässigen - пренебрегать, умалять  
den Hörer abnehmen - поднимать трубку 