Stimmungen

r Ärger - злость
s Glück - счастье
e Freude - радость
e Sorge - беспокойство
r Neid - зависть
r Stress - стресс
e Aufregung - волнение
e Furcht - боязнь
e Angst - страх
e Trauer - печаль
e Wut - ярость
r Mut - мужество
e Rache - мечть
r Trost - утешение
s Leid - горе, печаль 
e Feindschaft - вражда
r Haß - ненависть
e Muße - время прилежного делания раби себя
e Unrast - неугомонность, обеспокоеннсть
e Nachsicht - снисхождение
e Härte - твёрдость
e Langweile - скука
e Tätigkeit - занятость (есть что делать)
e Geborgenheit - чувство безопасности
e Verlassenheit - заброшенность, одиночество
r Eigennutz - корысть
e Hilfsbereitschaft - готовность помочь 
e Heiterkeit - веселость
e Anteilnahme - участие, сочувствие

