TEXT GLÜCK:

aus biologischer Sich - с биологической точки зрения
tendiered zu - иметь тенденцию к
leichtsinnig - безрассудный
übersehen - не замечать, пропускать, упускать
die Abwehrhaltung - защитная позиция
vor allem und jedem - перед всем и каждым
der Vortrag halten vor - делать доклад перед
hierfür - на это, для этого
das Lockmittel - приманка
das Ausleben - изживание (аффекта)
der Säugling - грудной ребенок
die Nahrungsaufnahme - принятие пищи
vorasugehen - предшествовать
r Vorgänger - предшественник
zufällig - случайный
unausweichlich - неизбежно
ausweichen - уступать место, давать дорогу, избегать кого-то
durchaus - совсем, совершенно, абсолютно, непременно
krass - резкий, неприятный, разящий
krass - резко
flüchtig - мимолетный
loswerden - избавляться, освобождаться
antreiben - погонять, поощрять
vertreiben - прогонять
treiben - гнать
betreiben - приводить в действие, приводить в движение
Chances haben für - иметь шансы на
hingegen - напротив (натомість)
namenlos - безымянный, неизвестный
schicksalhaft -  фатальный, судьбоносный
mildern - смягчать, облегчать